||||||||
|102333|
|102455|
|1**467$
|080067|
|08aa6b|
|99000b|
||||||||